NO ./textures/mossy.xpm


SO ./textures/wood.xpm



WE ./textures/redbrick.xpm



EA ./textures/greystone.xpm

F 220,100,0
C 225,30,0
1111111111
1000000001
1000000011
100N000011
1000000111
1000000011
1000000011
1000000001
1000000011
1111111111