NO ./textures/mossy.xpm


SO ./textures/wood.xpm



WE ./textures/redbrick.xpm



EA ./textures/greystone.xpm

F 220,100,0
C 225,30,0
111111111111
110011110001
100000000011
100N00000011
10000001111
100000111111
100000111111
10000000001
10010000111
1111111111