NO ./textures/mossy.xpm
SO ./textures/wood.xpm
WE ./textures/redbrick.xpm
EA ./textures/greystone.xpm

F 220,100,0
C 225,30,0

111111111111
110011110001
100100000011
100E0001111
100000111111
10000000001
10010000111
1111111111